00 00 01 01 01 01 01 01 01 01 01 01 01 01 01 01 01 01 08 09 10 11 00 00 00 00 00 00 00 00 00 00 
01 00 00 00 00 01 00 00 01 00 01 01 01 01 01 01 01 01 08 09 10 10 01 00 00 03 00 00 00 01 02 00 
01 00 01 01 00 02 00 00 00 02 01 01 01 01 01 01 01 01 08 08 10 00 00 02 00 01 00 03 00 01 02 00 
01 00 00 01 00 02 02 03 00 02 04 04 04 04 04 01 01 01 08 09 09 08 00 00 00 01 02 03 00 02 02 00 
01 02 00 00 00 03 00 00 00 01 04 04 04 04 04 01 01 01 08 09 11 08 01 00 00 01 01 03 00 01 02 00 
01 00 00 00 02 00 00 02 00 00 01 01 01 04 04 01 01 01 08 09 10 11 00 03 00 00 02 00 00 01 02 00 
01 03 00 00 00 00 00 00 02 02 01 01 01 04 04 01 01 01 01 01 01 01 01 01 01 01 01 01 01 01 02 01 
01 00 03 03 00 00 03 00 00 02 01 01 01 04 04 06 05 04 04 04 05 04 05 07 01 01 01 01 01 03 00 01 
01 01 00 01 00 00 00 02 00 02 01 01 01 04 04 04 04 05 05 05 07 06 05 07 01 01 01 01 01 00 00 01 
01 01 00 02 03 00 00 03 02 00 01 02 01 01 01 01 01 01 01 01 01 01 01 01 01 01 01 01 01 00 00 01 
01 03 01 01 03 00 00 01 01 00 01 02 03 01 01 01 01 01 01 01 01 01 01 02 03 01 01 01 01 03 00 01 
01 02 03 00 00 01 02 02 00 00 01 02 03 01 01 01 01 01 01 01 01 01 01 02 03 01 01 01 01 03 00 01 
01 00 02 00 00 01 02 03 03 00 01 02 03 02 01 01 01 01 01 01 02 01 01 02 03 01 01 01 01 03 02 01 
01 00 00 00 00 00 00 02 02 00 01 02 03 02 01 00 01 01 03 01 02 01 01 02 03 01 01 01 02 00 02 01 
01 01 00 02 03 00 00 03 03 00 01 01 03 02 01 00 01 01 03 01 02 01 01 02 03 01 01 01 01 03 02 01 
01 03 01 02 03 00 00 01 00 00 00 01 01 02 01 00 01 01 03 01 02 01 01 01 01 01 01 01 01 00 00 01 
01 02 03 00 00 01 02 02 00 00 00 01 01 02 01 00 01 01 03 01 02 01 01 01 01 01 01 01 01 03 02 01 
01 00 02 00 00 01 02 03 00 00 00 01 01 01 01 00 01 01 03 01 02 01 01 01 01 01 01 01 01 03 00 01 
01 00 00 00 00 00 00 02 00 03 00 01 01 01 01 00 01 01 03 01 01 01 01 01 01 01 01 01 01 03 00 01 
01 01 00 02 03 00 00 03 00 00 00 01 01 01 01 01 01 01 01 01 01 01 01 01 01 01 01 00 01 00 00 01 